10 10
##########
..#......#
#.#.#.##.#
#.#.####.#
#.#....#.#
#.#.####.#
#.#....#.#
#.####.#.#
#......#..
##########
